"Value Date","Description","Debit","Credit","Balance"
"2022/10/06","振込・振替:ｺﾝﾆﾁﾊ","","1","7"
"2022/10/06","税引前利息","","1","6"
"2022/10/06","地方税","1","","5"
"2022/10/06","国税","1","","6"
"2022/10/06","KONNICHIHA Ｊデビット出金","1","","6"
"2022/10/06","ATM 現金出金（提携取引）","1","","7"
"2022/10/06","ＮＥＴ 振込・振替","1","","8"
"2022/10/06","GAICAカード チャージ","1","","9"
